11111
1CP01
10101
1C001
10001
11011
100C1
10001
10001
10001
10001
1C001
10101
10C01
1E001
11111
