111111111111111
1P0000000000001
1000000C0C000E1
111111111111111
