111111
1PC001
101001
1C0001
100001
110011
1000C1
100001
100001
101001
100001
1C0001
101001
10C001
1E0001
111111
