111111111111111111111
1000C0000000000010001
101111011111101110101
100000000100000000001
111011110101101110111
1000C000C000001C000P1
100111110101101110111
10000000000000000C001
101111111111101111101
100000000001E000000C1
111111111111111111111
