11111111111111111111111111111
1P00001000C010000000000100001
1000000C0100000001C00000000E1
11111111111111111111111111111
