111111111
100001101
101100001
1PEC00001
111111111
